Атрокс|Трахать убивать убивать трахать|топ
Ари|Лисичка чисто похихикать|мид
Акали|Мать была кулаком тени|топ|мид
Алистар|ЭЭЭЙ ЭТО НЕ ДЛЯ ДОЙКИ|сап
Амуму|поной еще|лес|сап
Анивия|Этот герой просто имба|мид
Энни|JAX ALERT!!!|мид
Эш|Лед лук и кал|адк|сап
Азир|Юзлес герой|мид
Блицкранк|Никита, не надо...|сап
Брэнд|Спишь?|мид|сап
Браум|Самый сильный мускул это пенис|сап
Кейтлин|Шериф мусорнулся|мид|адк
Кассиопея|Кошка|мид
Чо гат|ОМНОМНОМНОМ|топ
Корки|Рерольни пж|мид
Дариус|Лейнбули без будущего|топ
Диана|Диана|лес|мид
Доктор Мундо|Доктор ээээ на месте!|топ
Дрейвен|Удаляется|адк
Элиза|У нее есть дети???|лес
Эвелинн|У нее нет детей(предохраняется)|лес
Эзреаль|Люкс пжпжпжпж|адк
Фиддлстикс|Бу.|лес
Фиора|Мечтай о достойном противнике|топ
Физз|С тобой скучно...|мид
Галио|Гигачад|мид|сап
Гангпланк|Повесьте их в кровавых доках|топ
Гарен|Лайк если за справедливость|топ
Гнар|Гнаааар|топ
Грагас|Я перепью тебя даже после бочки грога|топ|лес
Грэйвз|Мидер берет твистеда фэйта|лес
Гекарим|Лошади|лес
Хеймердингер|1 в 3 на втором уровне|топ|мид|саппорт
Ирелия|Умеешь?|топ|мид
Жанна|Чето заун спасла хз че за герой|сап
Джараван IV|ЗА КОРОЛЯ(За него?)|лес
Джакс|Энни беги|топ|лес
Джейс|Лайк если бы побурил ноксианское ущелье|топ|мид
Джинкс|Лайк если бы взорвал что-нибудь|адк
Калиста|От какого слова ее имя?|адк
Карма|Саппорт гигачадов|сап
Картус|Ультани пж|лес|мид|адк
Кассадин|Против мальфита имба|топ|мид
Катарина|Против виктора гавно|мид
Кейл|ЗасКЕЙЛься|топ
Кеннен|Стремный герой|топ
Казикс|Статуи понастрой пж|лес
Ког`Мао|Плюйся. Адаптируйся. Выживай|адк
Ле Блан|Е Блан|мид
Ли Син|Не вижу ничего смешного в шутках про слепоту|лес
Леона|Затмение близко|сап
Лиссандра|С замерзших по лайку|мид
Люциан|Реролл|адк
Лулу|Думательная шапочка|сап
Люкс|Имба саппорт|мид|сап
Мальфит|Твердость скалы|топ
Мальзахар|Чучело с бездны|мид
Маокай|Чучело с островов|топ|лес|сап
Мастер Йи|Комбо на мастера йи.txt|лес
Мисс Фортуна|Красивый герой|адк
Мордекайзер|ДОБРО ПОЖАЛОВАТЬ В БРАЗИЛИЮ|топ
Моргана|Я ношу оковы, но меня не сломить|сап
Нами|есть|сап
Насус|есть|топ
Наутилус|НИКИТА ДАВАЙ|сап
Нидали|Хороша только как горничная|лес
Ноктюрн|Тьма мусор|лес|мид
Нуну и Виллумп|Кто последний тот старый вонючий пидор|лес
Олаф|Разграбим все|топ|лес
Ориана|Защищай|мид
Пантеон|Самый крутой мультипик|топ|мид|сап
Поппи|Самый крутой йордл|топ|лес|сап
Квинн|Мои друзья высоко взлетели|топ
Раммус|ОК|лес
Рек'Сай|ЙОЦОЙУОЦЙОУОЙЦОУ|лес
Ренектон|АААА крокодил в ванной|топ
Ренгар|6 зуб?|лес
Ривен|Для таких как ты и сломанного клинка достаточно|топ
Рамбл|Гавно|топ
Райз|Гавно|мид
Седжуани|Щетинка ко мне|лес
Шако|Цирк какой-то|топ|лес|сап
Шен|Я восстановлю равновесие|топ|
Шивана|Смолдер ее ребенок?|лес
Синджед|Как насчет выпить?|топ
Сион|ТРУСЫ|топ
Сивир|Ну в лейт норм|адк
Скарнер|Когда реворк?|лес
Сона|...|сап
Сорака|ПОХИЛЬ МЕНЯ БЛЯТЬ УЕБИЩЕ|сап
Свейн|Мид имба рилай|топ|мид|сап
Синдра|Синдра.|мид
Талон|Ахахахахах ТалОн|лес|мид
Тарик|♂♂♂♂♂♂|сап
Тимо|Будь готов всегда готов, будь готов всегда готов|топ
Треш|Что за треш|сап
Тристана|Экшули, ноль станов|адк
Трандл|ВЫШКИ ВЫШКИ ВЫШКИ|топ|лес
Триндамир|ВЫШКИ ВЫШКИ ВЫШКИ|топ|лес
Твистед Фэйт|Ясный, как небо|мид
Твич|Крысы|адк|сап
Удир|Не герой|лес
Ургот|Урод.|топ
Варус|Если интересно за геев играть, то вперед...|адк
Вейн|Ее родителей убила Эвелинн. Интересно, как|топ|адк
Вейгар|Заскейлся и проиграй|мид
Вел'Коз|Не герой, реролл бесплатно|мид|сап
Вай|ЭТО ВИБРАЦИЯ|лес
Виктор|В Катарину норм|топ|мид
Владимир|Владимир?..|топ|мид
Волибир|Гигачад|топ|лес
Варвик|Слушай, а это довольно смело...|топ|лес
Вуконг|Мартышки|топ
Зерат|Не попадешь даже|мид|сап
Ксин Жао|Очень сложный|лес
Ясуо|Смерть самый легкий выход...|топ|мид|адк
Йорик|ВЫШКИ ВЫШКИ ВЫШКИ|топ
Зак|Адк имба|лес
Зед|Ты либо новичок, либо гей|мид
Зиггс|Распрыжечка|мид|адк
Зилеан|Самое время|сап
Зайра|Засадили бы?|мид|сап
Бард|*звуки саксофона*|сап
Экко|Время|лес|мид
Таам Кенч|Лизнул бы?|топ|сап
Киндред|Любовь смерть и овцы|лес
Иллаой|Электричка????|топ
Джин|4.|адк
Аурелион Сол|Не пикай пж|мид
Талия|Что это за герой|лес|мид
Клед|Видел тот знак на входе?|топ
Иверн|Инвейд?|лес
Камилла|Хирурга от мясника отличает лишь точность|топ
Рейкан|Адк Шая доступна|сап
Шая|Сап Рейкан доступен|адк
Каин|Авель?|лес
Орн|Порн|топ
Зои|НЕ ПИКАЙ ЕЕ УМОЛЯЮ|мид|сап
Кай'са|Няшка|адк
Пайк|Спайк(герой бравлстарса)|сап
Нико|Щема нико разлетелась повсюду... Кошмар... Пришлось собирать|мид|сап
Сайлас|Я БЫЛ В ТЮРЬМЕ|мид
Юми|На одного героя меньше|сап
Киана|А ляжки какие...|мид
Сенна|Люциан не человек|сап
Афелий|По пути на лайн..|адк
Сетт|Обязательно выиграть лайн|топ
Лиллия|КОЗЫ|лес
Ёнэ|Не пикай|топ|мид
Самира|СТРЕЛЬБА ПО ДВИЖУЩЕЙСЯ ЦЕЛИ|адк
Серафина|SERAPHINE|сап
Релл|На троечку|сап
Виего|ИЗОЛЬДА|лес
Гвен|Чик-чик|топ
Акшан|Вы негодяй. Акшан охотится на вас|мид
Векс|Как же она ноет|мид
Наафири|Обмен интересует?|мид
Миллио|JAX ALERT|сап
Хвэй|Не герой пока|мид